########################################################################
# Categories by Mimetypes Setting
#
# New mimetypes must be defined by signature or extension in conf/CustomSignatures.xml
#
########################################################################

RTF Documents = application/rtf

PDF Documents = application/pdf

HTML Documents = text/html; application/xhtml+xml; application/vnd.wap.xhtml+xml; application/x-asp; text/asp; text/aspdotnet

XML Files = application/xml; application/rdf+xml; application/rss+xml; application/vnd.google-earth.kml+xml

Text Documents = application/vnd.ms-wordml; application/x-tika-ooxml-protected-docx; application/vnd.apple.pages; application/msword; application/msword2; application/msword5; application/vnd.ms-word.document.macroenabled.12; application/vnd.ms-word.template.macroenabled.12; application/vnd.openxmlformats-officedocument.wordprocessingml.document; application/vnd.openxmlformats-officedocument.wordprocessingml.template; application/vnd.oasis.opendocument.text; application/vnd.oasis.opendocument.text-master; application/vnd.oasis.opendocument.text-template; application/vnd.oasis.opendocument.text-web; application/vnd.sun.xml.writer; application/vnd.sun.xml.writer.global; application/vnd.sun.xml.writer.template; application/vnd.stardivision.writer;

Spreadsheets = application/vnd.ms-spreadsheetml; application/x-tika-ooxml-protected-xlsx; text/csv; application/vnd.apple.numbers; application/vnd.ms-excel; application/vnd.ms-excel.addin.macroenabled.12; application/vnd.ms-excel.sheet.macroenabled.12; application/vnd.ms-excel.sheet.binary.macroenabled.12; application/vnd.ms-excel.template.macroenabled.12; application/x-tika-msworks-spreadsheet; application/vnd.openxmlformats-officedocument.spreadsheetml.sheet; application/vnd.openxmlformats-officedocument.spreadsheetml.template; application/vnd.oasis.opendocument.spreadsheet; application/vnd.oasis.opendocument.spreadsheet-template; application/vnd.sun.xml.calc; application/vnd.sun.xml.calc.template; application/vnd.stardivision.calc; application/x-tika-old-excel

Presentations = application/x-tika-ooxml-protected-pptx; application/vnd.apple.keynote; application/x-corelpresentations; application/vnd.ms-powerpoint; application/vnd.ms-powerpoint.addin.macroenabled.12; application/vnd.ms-powerpoint.presentation.macroenabled.12; application/vnd.ms-powerpoint.slide.macroenabled.12; application/vnd.ms-powerpoint.slideshow.macroenabled.12; application/vnd.ms-powerpoint.template.macroenabled.12; application/vnd.openxmlformats-officedocument.presentationml.presentation; application/vnd.openxmlformats-officedocument.presentationml.slide; application/vnd.openxmlformats-officedocument.presentationml.template; application/vnd.openxmlformats-officedocument.presentationml.slideshow; application/vnd.oasis.opendocument.presentation; application/vnd.oasis.opendocument.presentation-template; application/vnd.sun.xml.impress; application/vnd.sun.xml.impress.template; application/vnd.stardivision.impress;

OLE files = application/x-tika-msoffice

Link files = application/x-lnk

Other Documents = application/vnd.ms-xpsdocument; application/vnd.visio; application/vnd.ms-project; application/x-project; application/vnd.ms-works; application/x-quattro-pro; application/sldworks; application/x-tika-ooxml-protected; application/onenote; application/x-msmoney; application/x-mspublisher; application/x-ms-owner; model/vnd.dwfx+xps; application/vnd.ms-graph;

Emails = message/rfc822; message/x-emlx; application/vnd.ms-outlook; message/outlook-pst; application/x-ufed-html-mails; message/x-ufed-email

Mailboxes = application/vnd.ms-outlook-pst; application/outlook-dbx; application/mbox; application/x-incredimail

Databases = application/x-edb; application/x-edb-table; application/irpf; application/x-msaccess; application/x-dbf; application/vnd.oasis.opendocument.database; application/x-sqlite3; application/x-mysql-db; application/x-berkeley-db

Compressed Archives = application/x-tika-ooxml; application/zlib; application/applefile; application/vnd.ms-tnef; application/zip; application/x-rar-compressed; application/x-tar; application/gzip; application/x-gzip; application/x-xz; application/x-bzip; application/x-bzip2; application/x-7z-compressed; application/x-arj; application/x-gtar; application/x-archive; application/x-cpio; application/x-tika-unix-dump; application/x-snappy-framed; application/x-snappy; application/x-snappy-raw; application/x-compress; application/x-java-pack200; application/x-lzma; application/x-lz4; application/x-lz4-block; application/x-brotli; application/zstd; application/deflate64; image/x-emf-compressed

Contacts = text/x-vcard; application/windows-adress-book; application/outlook-contact; application/x-livecontacts; application/x-livecontacts-table; contact/x-skype-contact; contact/x-skype-account; application/x-whatsapp-wadb; application/x-whatsapp-contactsv2; contact/x-whatsapp-contact; application/x-ufed-html-contacts; application/x-ufed-contact

Chats = application/messenger-plus; application/messenger-chat; application/sqlite-skype; application/skype; application/x-whatsapp-db; application/x-whatsapp-chatstorage; message/x-whatsapp-msg; message/x-skype-conversation; message/x-skype-message; message/x-skype-filetransfer; application/x-ufed-html-chats; application/x-ufed-chats-txt; application/x-ufed-chat; application/x-ufed-chat-whatsapp; application/x-ufed-chat-preview

Windows Registry = application/x-windows-registry; application/x-windows-registry-report

Programs and Libraries = application/java-archive; application/x-dosexec; application/x-msdownload; application/x-bat; application/vnd.ms-cab-compressed; application/x-font-ttf; application/pkcs7-signature; application/vnd.ms-htmlhelp; application/java-vm; application/vnd.ms-pki.seccat; application/x-ms-installer; application/x-ufed-html-apps; application/x-ufed-installedapplication

Unallocated = application/x-unallocated;

File Slacks = application/x-fileslack

Images = image; application/vnd.oasis.opendocument.graphics; application/vnd.oasis.opendocument.graphics-template; application/vnd.oasis.opendocument.image; application/vnd.oasis.opendocument.image-template; application/vnd.sun.xml.draw; application/vnd.sun.xml.draw.template; application/vnd.stardivision.draw;

Videos = video; application/vnd.rn-realmedia; application/x-shockwave-flash

Audios = audio;

Plain Texts = text

Other files = application/octet-stream; application/x-nls

Peer-to-peer = application/x-p2p

Internet History = application/x-msie-cache; application/x-webcache; application/x-webcache-table; application/x-ufed-html-webhistory; application/x-ufed-visitedpage

ISO disks = application/x-iso9660-image; application/x-udf-image;

Virtual disks = application/x-wim-image; application/x-vmdk; application/x-vhd; application/x-vdi

Other disks = application/x-disk-image;

# UFED

Extraction Summary = application/x-ufed-html-summary

Calls = application/x-ufed-html-calls; application/x-ufed-call

SMS Messages = application/x-ufed-html-sms; application/x-ufed-sms

MMS Messages = application/x-ufed-html-mms; application/x-ufed-mms

Instant Messages = application/x-ufed-instantmessage

Bluetooth Devices = application/x-ufed-html-bluetooth; application/x-ufed-bluetoothdevice

SIM Data = application/x-ufed-html-simdata; application/x-ufed-simdata

Calendar = application/x-ufed-html-calendar; application/x-ufed-calendarentry

Logs = application/x-ufed-html-logs; application/x-ufed-logentry

User Accounts = application/x-ufed-html-users; application/x-ufed-useraccount

Searches = application/x-ufed-html-searches; application/x-ufed-searcheditem

Web Bookmarks = application/x-ufed-html-bookmarks; application/x-ufed-webbookmark

Notes = application/x-ufed-html-notes; application/x-ufed-note

Wireless Networks = application/x-ufed-html-wifi; application/x-ufed-wirelessnetwork

Notifications = application/x-ufed-html-notifications; application/x-ufed-notification

Locations = application/x-ufed-html-locations; application/x-ufed-location

Cookies = application/x-ufed-html-cookies; application/x-ufed-cookie

Configuration = application/x-ufed-html-configurations

Passwords = application/x-ufed-html-passwords; application/x-ufed-password

Autofill = application/x-ufed-html-autofill; application/x-ufed-autofill

Cell Towers = application/x-ufed-html-celltowers; application/x-ufed-celltower

Power Events = application/x-ufed-html-energyevents; application/x-ufed-energyevent; application/x-ufed-powerevent

User Dictionaries = application/x-ufed-html-userdict; application/x-ufed-dictionaryword

IP Connections = application/x-ufed-html-ips; application/x-ufed-ipconnection

Recordings = application/x-ufed-html-recordings; application/x-ufed-recording

Mobile Cards = application/x-ufed-mobilecard

Application Usage = application/x-ufed-applicationusage